######L#######################
#.#.*.**.*.\..#.#.#\.#.\.\.###
#.\\.\*\\.\.*.#\\*##\#.#.#.\.#
#.\#\..\..*.\\##\#..\.\.#...##
#\..\\..##..\*\#\#\*#...*\#.##
##..##*.#..#.\...#*\\*##..\..#
#\.\.*..#...\#...*\.\#\*.\*\*#
#.*.#.R..*.*#.*.....##\...#*.#
##.#.\.\.#\.*.*..\.#....#*.#*#
##..\.\..*..\.###.\\..*...\\\#
#.#\\...*#...#....*.\.\\*..###
#\..#.*\*.\#*\.#.\\...\..\*\.#
#..#.##...*#...*.*\#..#.\*\..#
##.....\..#*####\.##.#*\.*\.\#
##############################