######################
#..R#.........\\\\\..#
#...#..#...#..#####..#
#...#..#...#....#\...#
#...####\#*#....#....#
#...\\\#.............#
#.#################..#
#.........\\\... *...#
#...\........... #...#
#...\..***..#... ....#
#...\.......#..# *..\#
#...\\\\\...#..#\#..\#
#...........##......\#
#.#..........######..#
#.#..#########.......#
L.#....#.....#.......#
#####..#...\\#.......#
#....**#.##*########.#
#......#.#.....#.....#
#\\\\\...#...........#
######################